# Level 0 -------------------------
...121212121212121212121212.....
...434343434343434343434343.....
.......1212121212121212.........
.......4343434343434343.........
.....12121212121212121212.......
.....43434343434343434343.......
...121212121212121212121212.....
.124343434343434343434343431212.
.431212121212121212121212124343.
...434343434343434343434343.....
.....12121212121212121212.......
.....43434343434343434343.......
.......1212121212121212.........
.......4343434343434343.........
...121212121212121212121212.....
...434343434343434343434343.....
# Level 1 -------------------------
................................
................................
.........121212121212...........
.........434343434343...........
.........121212121212...........
.........434343434343...........
.........121212121212...........
.........434343434343...........
.........121212121212...........
.........434343434343...........
.........121212121212...........
.........434343434343...........
.........121212121212...........
.........434343434343...........
................................
................................
# Level 2 -------------------------
................................
................................
................................
................................
...........12121212.............
...........43434343.............
...........12121212.............
...........43434343.............
...........12121212.............
...........43434343.............
...........12121212.............
...........43434343.............
................................
................................
................................
................................
# Level 3 -------------------------
................................
................................
................................
................................
................................
................................
.............1212...............
.............4343...............
.............1212...............
.............4343...............
................................
................................
................................
................................
................................
................................
# Level 4 -------------------------
................................
................................
................................
................................
................................
................................
................................
..............12................
..............43................
................................
................................
................................
................................
................................
................................
................................